1111111111111111
1P01000000000011
1000011111000001
100011E000001001
1110111101111011
10000000000000C1
1111111111111111
