1111111111111111
1001000000000011
1E000111110000C1
1P00110000001001
1110111101111011
1C000000000000C1
1111111111111111
