1111111111111111
1001000000000011
1E00011111000001
1P00110000001001
1110111101111011
100000000000C0C1
1111111111111111
