111111111111111111111111
1E0000000000000CC0000001
101001010010010010010101
101001001010101010010101
1P0000000C00C000000000C1
111111111111111111111111
