1111111111111111111111
1PCCCCCCCCCCCCCCCCCCC1
1CCCCCCCCCCCCCCCCCCCC1
1CCCCCCCCCCCCCCCCCCCC1
1ECCCCCCCCCCCCCCCCCCC1
1111111111111111111111