111111111111111
1P00000000000C1
111011101110101
1C00000000000C1
111011101110101
1C00000000000C1
111111000111111
1C00000000000E1
111111111111111