11111111111
1C0000000E1
1PA00000001
11111111111