11111111111
1E0001000C1
1P000100001
11111111111
