11111111111111
1C0001000E1
1P000100001
11111111111