11111111111
1C0000000E1
1P000000001
11100001111
